1111111111111
1001C000000C1
10C0001010001
1P0011E000011
1111111111111